11111111111111111111
10000000000000000001
10111111111111111001
10100000000000011001
10101111111111111001
10100000000000000001
10111111111111111111
10000000000000000001
11111111111111111101
10000000000000000001
10111110111111111001
10100010100000011001
10101110111111011001
10100000100000000001
10111110111111111111
10000010000000000001
11111111111111111001
10000000000000001001
10000000000000002001
11111111111111111111
